월,상품1,상품2,상품3,상품4,상품5,합계,수익
1,208,154,435,815,210,1822,14852000
2,180,156,510,620,208,1674,14212000
3,235,135,476,950,350,2146,17460000
4,321,276,587,870,218,2272,19150000
5,295,208,487,760,178,1928,16066000
6,260,210,510,790,208,1978,16520000
7,275,147,470,880,212,1984,16064000
8,298,125,532,960,258,2173,17544000
9,327,189,590,810,198,2114,17624000
10,198,178,789,987,213,2365,19662000
11,243,235,695,1201,256,2630,21480000
12,180,180,698,1323,198,2579,20498000
